{
  "tailleCase":32,
  "x":32,
  "y":64,
  "hauteur":18,
  "largeur":25,
  "grid":[[0,0,0,0,0,0,0,0,0,0,0,0,0,0,0,0,0,0,0,0,0,0,0,0,0], 
          [0,0,0,0,0,0,0,0,0,0,0,0,0,0,0,0,0,0,0,0,0,0,0,0,0],                              
          [0,1,1,1,1,1,1,1,1,1,1,1,1,1,1,1,1,1,1,1,1,1,1,1,0], 
          [0,1,0,0,0,0,8,0,0,1,0,0,0,0,0,0,0,0,0,0,0,0,0,1,0], 
          [0,1,0,1,0,0,0,0,0,1,0,1,1,1,1,1,2,1,1,1,0,4,0,1,0], 
          [0,1,0,1,0,0,4,0,0,1,0,0,0,0,0,0,0,0,0,1,0,0,0,1,0], 
          [0,1,0,1,0,0,0,0,0,1,0,0,4,0,0,1,0,0,0,1,0,0,0,1,0], 
          [0,1,0,1,0,0,0,0,0,1,0,0,2,0,0,1,0,4,0,1,0,0,0,1,0], 
          [0,1,0,1,2,1,1,1,1,1,0,0,0,0,0,1,0,0,0,1,0,0,0,1,0], 
          [0,1,0,1,0,0,0,0,0,0,0,0,0,0,0,1,0,0,0,1,0,1,0,1,0], 
          [0,1,0,1,1,1,1,1,1,1,1,1,1,1,1,1,1,1,1,1,0,0,0,1,0], 
          [0,1,0,0,2,0,0,0,0,1,1,1,1,0,0,0,0,0,0,1,0,0,0,1,0], 
          [0,1,0,1,9,1,1,1,1,1,1,4,0,0,0,0,0,2,0,1,0,2,0,1,0], 
          [0,1,0,1,9,1,0,0,0,1,1,1,1,0,0,0,0,0,0,1,0,0,0,1,0], 
          [0,1,0,1,1,1,0,0,0,0,0,0,0,0,2,0,0,0,0,1,0,0,0,1,0], 
          [0,1,0,0,0,0,0,0,0,1,1,1,1,0,0,0,0,0,0,0,0,0,0,1,0], 
          [0,1,1,1,1,1,1,1,1,1,0,0,1,1,1,1,1,1,1,1,1,1,1,1,0], 
          [0,0,0,0,0,0,0,0,0,0,0,0,0,0,0,0,0,0,0,0,0,0,0,0,0]]}